*** *************************************
* *               *   *       *         *
* ******* * ***** * * * * ***** *** *** *
*       * *   *     * * *         * *   *
******* * *** ********* ********* * * ***
*     * *   *         * * *     * * *   *
***** * *** ********* * * * *** * * *** *
*     * *     *     * * * *   * * * * * *
* ***** ***** * *** * * * *** * *** * * *
*     *     *   * * * * * *   *     * * *
* *** ***** ***** * * * * * * ******* * *
* *       *   *   * * *   * * *     *   *
* * ********* * *** * *** * *** *** *** *
* *     *     *     *   * * *     *   * *
* ***** * *********** * * * * ******* * *
* *     *   *       * *   *   *       * *
*** ******* *** *** * ********* ******* *
*   *     *     *   *     *   *   *   * *
* *** *** ******* ********* * *** * *** *
*       *                   *     *     *
************************* ***************
